#########
#S      #
# ##### #
# #   # #
# # ### #
#   # # #
### # # #
#   #  E#
#########