#########
#S  #   #
# ### # #
# #   # #
# # ### #
#   #   #
# #######
#      E#
#########