#########
#S      #
####### #
# #     #
# # ### #
# # #   #
# # # ###
#   #  E#
#########