#########
#S      #
##### ###
#   #   #
# # ### #
# #   # #
##### # #
#      E#
#########