#########
#S  #   #
# # ### #
# #     #
# ##### #
#   # # #
##### # #
#      E#
#########