#########
#S      #
##### ###
#   #   #
# ##### #
# #     #
# ### # #
#     #E#
#########