#########
#S  #   #
# # ### #
# # #   #
### # ###
#   #   #
# ##### #
#      E#
#########