#########
#S      #
# #######
# #     #
# ##### #
#     # #
# # ### #
# #    E#
#########