#########
#S    # #
# ### # #
# #   # #
### ### #
#   #   #
# ##### #
#      E#
#########