#########
#S      #
### # ###
# # #   #
# ##### #
# #   # #
# # # # #
#   #  E#
#########