#########
#S#   # #
# # ### #
# #     #
# ##### #
#   #   #
# # # ###
# #    E#
#########