#########
#S      #
##### # #
#   # # #
### # # #
# # # # #
# # # # #
#     #E#
#########