#########
#S#   # #
# ### # #
#   # # #
# ### # #
#   #   #
# # ### #
# #    E#
#########