#########
#S      #
# ##### #
#   # # #
##### # #
#   #   #
# ### ###
#      E#
#########