#########
#S#   # #
# ### # #
# #   # #
# # ### #
# # #   #
# # ### #
#      E#
#########