#########
#S      #
####### #
#     # #
# ##### #
# #     #
# ##### #
#      E#
#########