#########
#S    # #
# ### # #
# #   # #
# ### # #
# # # # #
# # # # #
#   #  E#
#########