#########
#S      #
# ##### #
# #   # #
# ### # #
# # # # #
# # # # #
#   #  E#
#########