#########
#S    # #
# ### # #
# #     #
# ##### #
# #   # #
# # ### #
#   #  E#
#########