#########
#S      #
# #######
#       #
# ##### #
# #     #
# #######
#      E#
#########