#########
#S  #   #
# # ### #
# #   # #
# ### # #
# # # # #
# # ### #
#      E#
#########