#########
#S      #
# ### ###
# # #   #
# # ### #
# # #   #
# # # # #
# #   #E#
#########