#########
#S      #
# ##### #
#   # # #
##### # #
#   #   #
# # # ###
# #    E#
#########