#########
#S      #
# # #####
# # #   #
# ##### #
#       #
# #######
#      E#
#########